Column_name	Rename	Abridged
sample_id	sample_id	T
CHROM	chr	T
POS	start	T
START	start	T
REF	ref	T
ALT	alt	T
rsID	rs_id	T
SYMBOL	gene_symbol_vep	T
Consequence	variant_classification_vep	T
HGVSg	HGVSg	T
HGVSc	HGVSc	T
HGVSp	HGVSp	T
final_call	autogvp_call	T
Reasoning_for_call	autogvp_call_reason	T
ClinVar_ClinicalSignificance	clinvar_clinsig_autogvp	T
ReviewStatus	clinvar_review_status_autogvp	T
Stars	clinvar_stars	T
VariationID	clinvar_variant_id	T
clinvar_flag	clinvar_flag	T
ClinVar_link	clinvar_variant_link	T
Intervar_evidence	intervar_evidence	T
gnomad_3_1_1_AF_non_cancer	gnomad_3_1_1_AF_non_cancer	T
final_call_clinvar	autogvp_call_clinvar	F
final_call_intervar	autogvp_call_intervar	F
Func.refGene	variant_location_annovar	F
Gene.refGene	hugo_symbol_annovar	F
GeneDetail.refGene	cDNA_change_annovar	F
ExonicFunc.refGene	variant_classification_annovar	F
AAChange.refGene	protein_change_annovar	F
Interpro_domain	interpro_domain	F
criterion	criterion_autopvs1	F
evidencePVS1	PVS1_autogvp	F
evidenceBA1	BA1_autogvp	F
evidencePS	PS_autogvp	F
evidencePM	PM_autogvp	F
evidencePP	PP_autogvp	F
evidenceBS	BS_autogvp	F
evidenceBP	BP_autogvp	F
intervar_adjusted	intervar_adjusted	F
AC	AC	F
AD_ref	AD_ref	F
AD_alt	AD_alt	F
AF	AF	F
DP	DP	F
ALLELEID	ALLELEID	F
AN	AN	F
BaseQRankSum	BaseQRankSum	F
ClippingRankSum	ClippingRankSum	F
LastEvaluated	clinvar_date_last_evaluated	F
CLNDISDB	clinvar_associated_disease	F
CLNDISDBINCL	clinvar_associated_disease_include_variant	F
CLNDN	clinvar_disease_name	F
CLNDNINCL	clinvar_disease_name_include_variant	F
CLNHGVS	clinvar_HGVS	F
CLNREVSTAT	clinvar_review_status_original	F
CLNSIG	clinvar_clinsig_original	F
CLNSIGCONF	clinvar_conflicting_significance	F
CLNSIGINCL	clinvar_clinsig_variant	F
CLNVC	clinvar_variant_type	F
CLNVCSO	clinvar_sequence_ontology	F
culprit	culprit	F
ExcessHet	ExcessHet	F
FS	FS	F
gnomad_3_1_1_AC	gnomad_3_1_1_AC	F
gnomad_3_1_1_AC_controls_and_biobanks	gnomad_3_1_1_AC_controls_and_biobanks	F
gnomad_3_1_1_AC_popmax	gnomad_3_1_1_AC_popmax	F
gnomad_3_1_1_AF	gnomad_3_1_1_AF	F
gnomad_3_1_1_AF_controls_and_biobanks	gnomad_3_1_1_AF_controls_and_biobanks	F
gnomad_3_1_1_AF_popmax	gnomad_3_1_1_AF_popmax	F
gnomad_3_1_1_AN	gnomad_3_1_1_AN	F
gnomad_3_1_1_AN_controls_and_biobanks	gnomad_3_1_1_AN_controls_and_biobanks	F
gnomad_3_1_1_AN_popmax	gnomad_3_1_1_AN_popmax	F
gnomad_3_1_1_nhomalt	gnomad_3_1_1_nhomalt	F
gnomad_3_1_1_nhomalt_popmax	gnomad_3_1_1_nhomalt_popmax	F
gnomad_3_1_1_primate_ai_score	gnomad_3_1_1_primate_ai_score	F
gnomad_3_1_1_splice_ai_consequence	gnomad_3_1_1_splice_ai_consequence	F
MLEAC	MLEAC	F
MLEAF	MLEAF	F
MQ	MQ	F
MQRankSum	MQRankSum	F
NEGATIVE_TRAIN_SITE;POSITIVE_TRAIN_SITE;QD	NEGATIVE_TRAIN_SITE;POSITIVE_TRAIN_SITE;QD	F
NEGATIVE_TRAIN_SITE;QD	NEGATIVE_TRAIN_SITE;QD	F
OLD_VARIANT	OLD_VARIANT	F
POSITIVE_TRAIN_SITE;QD	POSITIVE_TRAIN_SITE;QD	F
QD	QD	F
RAW_MQ	RAW_MQ	F
ReadPosRankSum	ReadPosRankSum	F
SOR	SOR	F
VQSLOD	VQSLOD	F
IMPACT	variant_impact_vep	F
Gene	ensembl_gene_vep	F
Feature	ensembl_transcript_vep	F
ENSP	ensembl_protein_vep	F
BIOTYPE	biotype_vep	F
EXON	exon_vep	F
INTRON	intron_vep	F
cDNA_position	cDNA_position_vep	F
CDS_position	cds_position_vep	F
Protein_position	protein_position_vep	F
Amino_acids	amino_acids_vep	F
Codons	codons_vep	F
DISTANCE	distance_vep	F
STRAND	strand_vep	F
PICK	pick_vep	F
VARIANT_CLASS	variant_class_vep	F
SYMBOL_SOURCE	gene_symbol_source_vep	F
HGNC_ID	hgnc_id_vep	F
CANONICAL	canonical_vep	F
TSL	TSL_vep	F
CCDS	CCDS_vep	F
SWISSPROT	SWISSPROT_vep	F
TREMBL	TREMBL_vep	F
UNIPARC	UNIPARC_vep	F
UNIPROT_ISOFORM	UNIPROT_ISOFORM_vep	F
RefSeq	refseq_transcript_vep	F
SOURCE	annotation_source_vep	F
SIFT	sift_vep	F
PolyPhen	polyphen_vep	F
DOMAINS	protein_domains_vep	F
CSQ	csq_vep	F